
NO      ./infos.txt                

SO ./infos.txt

EA ./infos.txt     
 WE ./infos.txt

F 255,255, 255
C 0,      0     , 0     


0000000
1111111
 0  E
1111111
10000001
          
