
NO      ./infos.txt                

SO ./infos.txt

EA ./infos.txt     
 WE ./infos.txt
F 253 ,255  , 255 

C 0,0,0    

1111111
 E
1111111
10000001
        
