NO ./makasamap/xpm/wonderland/wonderland_wall_north.xpm
SO ./makasamap/xpm/wonderland/wonderland_wall_south.xpm
EA ./makasamap/xpm/wonderland/wonderland_wall_east.xpm
WE ./makasamap/xpm/wonderland/wonderland_wall_west.xpm
F 179,144,96
C 159,228,245

11111111111
100000000N1
10000000001
10000000001
10000000001
10000000001
11111111111
