NO ./xpm/star_wars/star_wars_wall_north_HD.xpm
SO ./xpm/star_wars/star_wars_wall_south_HD.xpm
EA ./xpm/star_wars/star_wars_wall_east_HD.xpm
WE ./xpm/star_wars/star_wars_wall_west_HD.xpm

F 14,13,13
C 36,36,36

111 11111
101110001
100100001
101001001
100000001
111N00001
  1111111
