NO map/textures/blue_led_wall.xpm
SO map/textures/yellow_led_wall.xpm
WE map/textures/PIPES_2B.xpm
EA map/textures/BRICK_6D.xpm

F 255,1, 25 0
C 44,55,66

11111111
10000001
100S1101
10000001
11111111
