NO map/textures/BRICK_6D.xpm
SO map/textures/PIPES_1A.xpm
WE map/textures/PIPES_2B.xpm
EA map/textures/TECH_1E.xpm

F 10,226,40
C 80,20,220


11111111111111111111111111    111111111111111111111111111111111111111111111111
11111111111111111111111011    100000000000000000000000000000000000000000000011
10000000000000000000000001    100011111111111110000000000000011111111100011011
10111111111111111111111111    100011 1 1 1 1 1100000000000000001 1111111110011
10111111111111111111111111    10001 1 1 1 1 1 10000000000000000010000000000011
1001                          100011111111111110000000000000000100000000000011
1111    111111111111111111    100000000000000011111111111111111000000000000011
1111    100000000000000001    100000000000000000000000000000000000000000000011
1111    111111111111111111    100000000000000000000000000000000000000000000011
11111111111111111111111011    100000000000000000000000000000000000000000000011
10000000000000000000000001    100000000000000000000000000000000000000000000011
10111111111111111111111111    100000000000000000000000000000000000000000000011
10111111111111111111111111    100000000000000000000000000000000000000000000011
1001                          100000000000000000000000000000000000000000000011
1111    111111111111111111    100000000000000000000000000000000000000000000011
1111    100000000000000001    100000000000000000000000000000000000000000000011
1111    111111111111111111    100000000000000000000000000000000000000000000011
11111111111111111111111011    100000000000000000000000000000000000000000000011
10000000000000000000000001    100000000000000000000000000000000000000000000011
10111111111111111111111111    100000000000000000000000000000000000000000000011
10111111111111111111111111    100000000000000000000000000000000000000000000011
1011                          100000000000000000000000000000000000000000000011
1111    111111111111111111    100000000000000000000000000000000000000000000011
1111    100000000000000001    100000000000000000000000000000000000000000000011
1111    111111111111111111    1S0000000000000000000000000000000000000000000011
11111111111111111111111111     11111111111111111111111111111111111111111111111
