NO map/artw/kadinsky.xpm
SO map/artw/kadinsky2.xpm
WE map/artw/kadinsky3.xpm
EA map/artw/kadinsky4.xpm


F 10,50,50
C 10,10,10

111111111111111
100000000000001
100000101000001
100100010001001
100000000000001
100001000100001
100000000000001
100100000001001
100000000000001
1000000N0000001
111111111111111
