NO map/textures/BRICK_6D.xpm
SO map/textures/PIPES_1A.xpm
WE map/textures/PIPES_2B.xpm
EA map/textures/TECH_1E.xpm

F 10,226,40
C 80,20,220

1111111111
1010000001
11N0000001
1111111111
