NO map/textures/test.xpm
SO map/textures/test.xpm
WE map/textures/test.xpm
EA map/textures/test.xpm

F 255,0,255
C 0,0,0

11111111111111111111111111111
10000000000000000000000000001
10000000000000000000000000001
10000000000000000000000000001
10000000000000000000000000001
10000000000000000000000000001
10000000000000000000000000001
10000000000000N00000000000001
10000000000000000000000000001
10000000000000000000000000001
10000000000000000000000000001
10000000000000000000000000001
11111111111111111111111111111
