NO map/textures/blue_led_wall.xpm
SO map/textures/yellow_led_wall.xpm
WE map/textures/PIPES_2B.xpm
EA map/textures/BRICK_6D.xpm

F 192,202,152
C 152,199,202

1111111111111111111111111111111111
1000000000000000000000000000000001
1000000000000000000000000000000001
1000100010011111001000000111110001
1000110110010001001000000100010001
1000101010011111001000000100010001
1000100010010001001000000100010001
1000100010010001001111100111110001
100000N000000000000000000000000001
1000000000000000000000000000000001
1111111111111111111111111111111111
