NO map/textures/blue_led_wall2.xpm
SO map/textures/yellow_led_wall.xpm
WE map/textures/blue_led_wall.xpm   
EA 'map/textures/blue_led_wall3.xpm'

F 10,220,40
C 80,20,220     
 
1111111
100  0
1011111
10E00001
1111111
          
