NO map/textures/blue_led_wall2.xpm
SO map/textures/yellow_led_wall.xpm
WE map/textures/blue_led_wall.xpm   
EA 'map/textures/blue_led_wall3.xpm'

F 10,220,40
C 80,20,220     



1111111111111111111111111
1110111111001000000010111
1110011000001011111000111
1  101101101101  11011  1
1110010011011011110000111
11100001 1000000000001011
1111111111111111111111111

