NO map/textures/blue_led_wall2.xpm
SO map/textures/yellow_led_wall.xpm
WE map/textures/blue_led_wall.xpm
EA map/textures/blue_led_wall3.xpm

F 10,226,40
C 80,20,220     

111111111111111111111111111111
111011111100100000001011111111
111001100000101111100011111111
1  101101101101  1101111111111
111001001101101111000011111111
10000001 10N000000000101111111
100111111111111101111111111111
100111111111111101111111111111
100000000000000000000000000001
100111111111111100111001011101
100111111111111100111101011101
100111111111111100110001000001
100111111111111100110111011101
100111111111111100000000011101
100000000000000000000000000001
111111111111111111111111111111
