NO map/textures/blue_led_wall2.xpm
SO map/textures/yellow_led_wall.xpm
WE map/textures/blue_led_wall.xpm
EA map/textures/blue_led_wall3.xpm

F 10,226,40
C 80,20,220     

11111111111111111111111111111
11101111110010000000101111111
11100110000010111110001111111
1  101101101101  110111111111
11100100110110111100001111111
11100001 10N00000000010111111
11111111111111110111111111111
11111111111111110111111111111
11111111111111110000000001111
11111111111111110011100101111
11111111111111110011110101111
11111111111111110011000101111
11111111111111110011011101111
10000000000000000000000000001
11111111111111111111111111111
