NO map/textures/blue_led_wall2.xpm
SO map/textures/yellow_led_wall.xpm
WE map/textures/blue_led_wall.xpm
EA map/textures/blue_led_wall3.xpm

F 10,226,40
C 80,20,220     

11111111111111111111111111111111111111111111111111111111111111111111111111111111111111111111111111111111111111111111111111111111111111111111111111111
1                                                                                                                                                   1
1 1111111111111111111111111111111111111111111111111111111111111111111111111111111111111111111111111111111111111111111111111111111111111111111111111 1
1 1E01111000000100000000000000000000000000000000000000000000000000000000000000000000000000001111111111111111011000000000000000000000000000000000001 1
1 1100000011110101111111111111111111111111111111111111111111111111111111111111111111111011101111100000000000011011111111111111111111111111111111101 1
1 1111111111110101111110000000000000000000000000000000000000000000000000000000000000001000000000001111111111000010000011000001000000000000000000101 1
1 1000000000010001111110111111111111111111111111111111111111111111111111111111111111101011111111111111111111111110111011011101011111111111111110101 1
1 1011111111011111111110110000000000001111111111111111111111111111111111111111111111101111000000000000000000000000111000011100010000000000000000101 1
1 1011111111000000000000110111111111101000000000000000000000000000000000000111111111100000011111111111111111111111111111111111111111111111111110101 1
1 1011111111111111111111110111111000001011111111111111111111111111111111110111111111111111111111000001110000011111111100000100001111111111111110101 1
1 1011100000000000000000000111111011111011111111111111111111111111111111110000000000111110000000011101110111011111111100101101101111111100000000101 1
1 1011101111111111111111111111111000000011111111111111111111111111111111111111111110000000111111111100000111000000000000100001100001111101111111101 1
1 1011101111111111111111111111111111111111111111111111111111111111111111111111111111111111111111111111111111111111111111111111111101111101111111101 1
1 1011100000000000000011111111111111111111111111111111111111111111111111111111111111111111111111111111111111111111111111111111111101111101111111101 1
1 1011111011111111111111111111111111111111111111111111111111111111111111111111111111111111111111111111111111111111111111111111111101111100001111101 1
1 1011111011111111111111111111111111111110000000000000000000000000000000000000000000000000000000000001111111111111111111111111111100111111101111101 1
1 1011111011111111111111111111111111111100000000000000011110000000000000000000001000000000000000000001111111111111111111111111111101111111101111101 1
1 1011111011111111111111111111111111111100011000000000010000000000011000110000000001000000001100000001111111111111111111111111111101111111101111101 1
1 1011111011111111111111111111111111111100000110000000000001000000011000001000010000010001010000000001111111111111111111111111111101111111101111101 1
1 1011000011111111111111111111111111111100000001100000010000000010000000000010000000000000000011110001111111111111111111111111111101111111101110001 1
1 1011011111111111111111111111111111111100000000011000010000010000000000000000100000000100000000000001111111111111111111111111111101111111101110101 1
1 1011000001111111111111111111111111111110000000000110000000000000000000000000000000000000000000000000000000000000000000000000000001110000001111101 1
1 1011111101111111111111111111111111111101111111111111111111111111111011111111111111111111111111111111111111111111111111111111111101110111111111101 1
1 1011111101111111111111111111111111111100000000000000000000000010000000001000000000000000000000000001111111111111111111111111111101110000111111101 1
1 1011111101111111111111111111111111111100000000000000000000000010111111101000000000000000000000000001111111111111111111111111111101111110111111101 1
1 10110000011111111111111111111111111111000000000000000000000000101     101000000000000000000000000001111111111111111111111111111101111110001111101 1
1 10110111111111111111111111111111111111000000000000000000000000101 111 101000000000000000000000000001111111111111111111111111111101111111101111101 1
1 10110111111111111111111111111111111111000000000000000000000000101 101 101000000000000000000000000001111111111111111111111111111101111000001111101 1
1 10110111111111111111111111111111111111000000000000000000000000101 111 101000000000000000000000000001111111111111111111111111111101111011111111101 1
1 10110001111111111111111111111111111111000000000000000000000000101     1010000000000000000000000000011111111111111111111111111 1101 11000011111101 1
1 10111101111111111111111111111111111111000000000000000000000000101111111010000000000000000000000000011111111111111111111111111 1101 11111011111101 1
1 10111001111111111111111111111111111111000000000000000000000000100000000010000000000000000000000000011111111111111111111111111 1101 11111011111101 1
1 10111000111111111111111111111111111111000000000000000000000000011111111100000000000000000000000000011111111111111111111111111 1101  1111000011101 1
1 10100000111111111111111111111111111111000000000000000000000000000000000000000000000000000000000000011111111111111111111111111 1111  1111011011101 1
1 10101111111111111111111111111111111111111111111111111111111111111111111111111111111111111111111111111111111111111111111111111      11110000011101 1
1 1010111111111111111111111111111111111111111111111111111111111111111111111111111111111111111111111111111111111111111111111111111111111111011111101 1
1 1010000000000000000000000000000000000000000000000000000000000000000000000000000000000000000111111111000000000001100000000000000000000000011111101 1
1 1011111111111111111111111111111111111111111111111111111111111111111111111111111111111111110000000000011111111101100111111111111111111111111111101 1
1 1011111111111111111111111111111111111111111111111111111111111111111111111111110001111111111111111111111111111101110011110000000111111111111111101 1
1 1011111111111111111111111111111111111011111111111111111111111111111111111100010101111111110000000000000000011100000011110101110111111111111111101 1
1 1011111111111111110001111111111111111011111111000000001111111111111111111101000101111111111111111111101111011111111111110001110111111111111111101 1
1 1000000000000000000100000000000000000000000000011111100000000000000000000001111100000000000000000000000000000000000000000111110000000000000000001 1
1 1111111111111111111111111111111111111111111111111111111111111111111111111111111111111111111111111111111111111111111111111111111111111111111111111 1
1                                                                                                                                                   1
11111111111111111111111111111111111111111111111111111111111111111111111111111111111111111111111111111111111111111111111111111111111111111111111111111
