NO map/artw/delaunay.xpm
SO map/artw/mondrian.xpm
WE map/artw/matisse.xpm
EA map/artw/bresil.xpm


F 100, 100, 100
C 70,  45,  70     

111111111111111
100000000000001
100000101000001
100100010001001
100000000000001
100001000100001
100000000000001
100100000001001
100000000000001
1000000E0000001
111111111111111
