NO map/onedir/hs.xpm
SO map/onedir/jul.xpm
WE map/onedir/lt.xpm
EA map/onedir/zm.xpm

F 10,226,40
C 80,20,220     

111111111111111111111111111111
101000000000000000000000000101
111000000000001000000000000111
100000000000000000000000000001
100000000000000000000000000001
100000000000000000000000000001
100010000000001000000000010001
100000000000000000000000000001
100000000000000000000000000001
10000000000000N000000000000001
111000000000001000000000000111
101000000000000000000000000101
111111111111111111111111111111
