NO map/textures/blue_led_wall2.xpm
SO map/textures/yellow_led_wall.xpm
WE map/textures/blue_led_wall.xpm
EA map/textures/blue_led_wall3.xpm

F 10,226,40
C 80,20,220     

11111111111111
1N111111111111
11011111111111
11101111111111
11110111111111
11111011111111
11111101111111
11111110111111
11111111011111
11111111101111
1        10111
11111111111111
11111111111111
11111111111111
