NO map/textures/blue_led_wall2.xpm
SO map/textures/yellow_led_wall.xpm
WE map/textures/blue_led_wall.xpm
EA map/textures/blue_led_wall3.xpm

F 10,226,40
C 80,20,220     

11111111
10000001
100W0001
10000001
11111111
