NO ./xpm/wonderland_wall_north.xpm
SO ./xpm/wonderland_wall_south.xpm
WE ./xpm/wonderland_wall_west.xpm
EA ./xpm/wonderland_wall_east.xpm
F 179,144,96
C 159,228,245

111
1011111
10S1001
1010011
1000N01
1110001
1111111